EA ./assets/textures/east.xpm
NO ./assets/textures/north.xpm
WE ./assets/textures/west.xpm
SO ./assets/textures/south.xpm

F 72,72,72
C 32,32,32

   111111111111111111
111   111           11   
1N            1111  11   
111       1           1
1111111111 111111111111
